Wog, Wwg, Wog, Wog, Wog, Wog, Wwg, Wog, Wwg, Wog, Wog, Wog, Wog, Wog, Wog, Wog, Wog, Wog, Wog, Wog, Gg, Gg
Wog, Wog, Wog, Wog, Wwg, Wwg, Gg, Wwg, Gg^Ecf, Wwg, Wog, Wog, Wog, Ww^Ewl, Wog, Wog, Wog, Wog, Gs^Ecf, Gg^Edb, Ce, Ce
Wog, Wog, Wog, Wwg, Gg^Ecf, Cme, 4 Kme, Chr, Gd^Vo, Wwg^Bw\, Wwg^Bw\, Ww^Vm, Wog, Wog, Wog, Wog, Wwg, Wwg, Wwg, Ce, 3 Ket, Ce
Wog, Wog, Wog, Wwg, Gd^Vo, Chr^Edb, Cme, Chr, Wwg, Wwg, Wwg, Wwg^Bw\, Gg, Wwg, Wwf, Wwg, Wwg, Wwg, Gg^Edb, Ce, Ce, Ce
Wog, Wog, Wog, Wwg, Wwg, Gg^Ecf, Gg^Edb, Wwg, Wwg, Wwg, Wog^Xo, Wog^Xo, Gs^Vh, Gg, Wog, Wwf, Wwg, Wwf, Re^Vct, Ce, Ce, Ce
Wog, Wog, Ww^Vm, Wwg, Wog, Wwg, Wog, Ww, Ww, Wog, Wog^Xo, Wwf, Wog^Xo, Wwg^Bw\, Wwg, Wog, Wwg, Gg^Ecf, Gll^Fp, Re^Vct, Gg, Gg^Ecf
Wog, Wog, Wog, Wwg, Wog, Ww, Ww, Wwg, Ww, Ww, Ww, Wog^Xo, Wog, Wog^Bw|, Wwg, Wwg, Gg, Gg, Gg, Gs, Gg, Gg
Wog, Wog, Wog, Ww^Ewl, Wog, Wog, Wog, Ww, Wog, Ww, Ww, Wwg, Wwg, Wwg^Bw|, Gg^Es, Gg^Efm, Gs^Fms, Gg, Gs^Fds, Gg^Es, Gg, Gg
Wog, Wog, Wog, Wwg, Wog, Wog, Wog, Ww, Wwg, Wog, Wwg, Ww, Gg, Wwg^Bw|, Gg^Ve, Gs^Fms, Gll^Fp, Gs, Gg^Ve, Gs^Fms, Gs, Gg
Wog, Wog, Wwg, Wwg, Wwg, Wog, Wwg, Wwg, Wwg, Wwg, Gg, Gg, Gs^Fms, Gg, Gs^Fms, Gg, Gg, Gg, Gs^Fms, Gg, Gg, Gg
Wwg, Wwg, Wwg, Wwg, Wwg, Wwg, Gg, Wwg, Gg, Hh, Gg, Gs^Fms, Gs^Esd, Gg, Gs^Fms, Gg, Gs, Gg^Esd, Gs^Fms, Gs^Fms, Rr^Efs, Rr
Wwg, Wwg, Gg, Hh, Hh, Gg, Hh, Hh, Gg, Gg, Gll^Fp, Gg, Gg, Gg, Gs^Fds, Gs^Fms, Gg, Gg, Gg^Efm, Gg, Rr, Gg
Wog, Wwg, Wwg, Hhd, Mm, Mm, Mm, Gs^Fms, Gs^Fms, Gg^Ve, Gg, Gs^Fms, Gg, Gg, Gll, Gg, Gs^Fms, Gs^Fds, Rr, Rr^Efs, Gs^Fms, Gg
Wog, Wog, Wwg, Hh, Hhd, Mm, Hhd^Vhhr, Gs^Fds, Gg, Gg, Gg^Efm, Gg, Rp, Gg^Es, Gg, Gs, Gd, Gg, Rrc, Gg^Ve, Gg, Gg
Wog, Wog, Wog, Wwg, Wwg, Hh, Gg, Gg, Rp, Rr, Rr^Efs, Rr, Gll^Fp, Rr, Rr, Gg^Efm, Rr, Gg, Rrc, Gs^Fms, Gs^Fds, Gg
Wog, Wog, Wog, Wog, Wwg, Wwg, Wwg^Bw/, Rr, Gg, Gs^Vc, Gd, Gg, Gg, Gs^Fms, Gg, Rr^Efs, Gg^Ve, Rrc, Gg, Gll^Fp, Gg, Gg
Gg, Gg^Efs, Gg, Wwg, Wwg^Bw/, Wwg^Bw/, Wwg, Wwf, Wwg, Gg, Gg, Gg, Gg, Gg^Efm, Gg, Gd, Gs^Fms, Rrc, Cv, Gg, Gg^Ve, Gs^Fms
Ce, Ce, Ce, Gg, Gg, Wwf, Wog, Wwg, Wog, Wwg, Wwg, Gg^Ve, Gs^Fms, Gll^Fp, Gg^Es, Gg, Cv, Cv, 2 Kv, Gll, Cv, Gs^Fms
Ce, 1 Ke, Ce, Ce, Gg^Efs, Wwf^Vm, Wwg, Wog, Wog, Wog, Wwg, Gg, Gg, Gs^Fms, Gg, Gs^Fms, Cv, Cv, Cv, Cv, Gs^Fms, Cv
Ce, Ce, Ce, Ce, Wog, Wog, Wog, Wog, Wog, Wog, Wog, Wwg, Gg, Gg, Gg, Gs^Fms, Gg, Gs^Fms, Gg, Cv, Cv, Cv
