Gs^Fms, Gs^Fms, Ce, Ce, Cme, Wog, Wog, Wog, Wog, Wog, Wwg, Wwg, Gs^Fms, Gs^Fms, Gs^Fms, Gs^Fms, Gs^Fms, Gs^Fms, Gs^Fms, Gs^Fms
Gs^Fms, Gg^Ve, Ce, Ce, 3 Kme, Cme, Ww^Vm, Wog, Wwg, Wwg, Gs^Fms, Gs^Fms, Cv, Cv, Cv, Gs^Fms, Gs^Fms, Gs^Fms, Gs^Fms, Gs^Fms
Wog, Gs^Fms, Gs^Fms, Ce, Cme, Cme, Wwg, Wwg, Gs^Fds, Gs^Fds, Gs^Fds, Gs^Fms, Cv, 4 Kv^Fp, Cv^Fds, Cv, Gs^Fms, Gs^Fms, Gs^Ve, Gs^Fms
Wog, Wwg, Wog, Wog, Wwg^Bw|, Wwg, Wwg, Wwg, Wwg, Gs^Fms, Gg^Ve, Gs^Fms, Gs^Fms, Cv, Cv^Fet, Cv, Gs^Fms, Gs^Fms, Gs^Fms, Gs^Fms
Wog, Wwg, Wog, Wwg, Wwg^Bw|, Wwg, Wog, Wog, Wwg, Gs^Fds, Gs^Fds, Gs^Fds, Gs^Fds, Gs^Fms, Gs^Fms, Gs^Fms, Gs^Fds, Gs^Fms, Gs^Fds, Gs^Fds
Wog, Wog, Wwg, Wwg, Wwg^Bw|, Wwg, Wwg, Wog, Wwg, Gs^Fds, Gs^Fms, Gs^Fds, Gs^Fms, Gs^Fds, Gs^Fds, Gs^Fms, Gs^Fms, Gs^Fms, Gs^Fds, Gs^Fds
Wog, Wog, Wwg, Wog, Wwg^Bw\, Wwg, Wwg, Wwg, Gg, Gs^Fms, Gs^Fds, Gs^Fms, Gs^Fds, Gs^Fds, Gg, Gs^Fms, Gs^Fds, Gg^Ve, Gs^Fds, Gs^Fms
Wog, Wog, Wog, Wwg, Wog, Wwg^Bw\, Wwg^Bw\, Wwg, Gg, Gg, Gg^Ve, Gg, Gg, Ce, 2 Ke, Ce, Gg, Gs^Fms, Gg, Gg
Wog, Wog, Wog, Ww^Vm, Wwg, Wwg, Gg, Gg, Gs^Fms, Gs^Fms, Gg, Gg, Gg, Ce, Gg, Ce, Gg, Gs^Fms, Gg, Gg
Wog, Wog, Wwg, Wwg, Wwg, Gs^Fms, Gs^Fms, Gs^Fms, Gs^Fms, Gg, Gs^Fms, Gs^Fms, Gg, Gg, Gg, Gg, Gs^Fms, Gs^Fms, Gg, Gg
Wog, Wog, Wwg, Wog, Wwg, Gs^Fms, Gg, Gg, Gg, Gs^Fms, Gg, Gg, Gg^Ve, Gs^Fms, Gs^Fms, Gs^Fms, Gg, Gs^Fms, Gg, Gg
Wog, Wog, Wwg, Wog, Wwg, Wwg, Gg, Gs^Fms, Gs^Fms, Gs^Fms, Gs^Fms, Gs^Fms, Gs^Fms, Gg, Gs^Fms, Gs^Fms, Gg, Gs^Fms, Gg, Gg
Wog, Wog, Wog, Wwg, Wwg^Vm, Wwg, Gg, Gg^Ve, Gs^Fms, Gg, Gs^Fms, Gg, Gg, Gs^Fms, Gg, Gg, Gg, Gg, Gg, Gg
Wog, Wog, Wwg, Wog, Wwg, Wwg, Gs^Fms, Gs^Fms, Gg, Gs^Fms, Gs^Fms, Gs^Fms, Gg, Gg, Gs^Fms, Gg, Gg^Ve, Gs^Fms, Gs^Fms, Gg
Wog, Wog, Wwg, Wwg, Wwg, Gg, Gg, Gs^Fms, Gg, Gg, Gg, Gg, Gg, Gg, Gg, Gs^Fms, Gg^Vct, Gg, Gg, Gg
Wog, Wog, Wwg^Vm, Wwg, Gg, Gs^Fms, Gs^Fms, Gg, Gg, Gg, Gg, Gs^Fms, Gs^Fms, Gg^Ve, Ce, Ce, Ce, Gg, Gg, Gg
Wog, Wog, Wwg, Wwg, Gg, Gs^Fms, Gg, Gs^Fms, Gg, Gg^Ve, Gg, Gs^Fms, Gg, Gg, Ce, 1 Ke, Ce, Gg^Vct, Gg, Gg
Wog, Wog, Wwg, Gg, Gg, Gg, Gs^Fms, Gg, Gs^Fms, Gg, Gs^Fms, Gg, Gg, Gg, Gg, Ce, Gg, Gg, Gg, Gg
Wog, Wog, Wwg, Gg, Gg, Gg, Gg, Gs^Fms, Gg, Gg, Gg, Gs^Fms, Gg, Gs^Fms, Gg, Gg, Gg, Gg, Gg, Gg
