Wog, Wog, Wog, Gg, Gg, Gg, Gg, Gg, Ch, Ch, Rrc, Rrc, Rrc, Rrc, Rrc, Ch, Ch, Gll^Fmf, Gll^Fmf
Wog, Wog, Wog, Gg, Gll^Fmf, Gg, Gg, Gg, Ch, Rrc, Rr^Vhc, Rr^Vhc, Cud, Rr^Vhc, Rr^Vhc, Rrc, Ch, Gll^Fmf, Gll^Fmf
Wog, Wog, Wog, Gg, Gll^Fmf, Gll^Fmf, Gg, Gg, Ch, Rrc, Rr^Vhc, Cud, 1 Kud, Cud, Rr^Vhc, Rr^Vhc, Ch, Gg, Rrc
Wog, Wog, Wog, Gg, Gg, Gg, Gll^Fmf, Gg, Ch, Rrc, Rrc, Cud, Cud, Cud, Rr^Vhc, Rrc, Ch, Rrc, Gg
Wog^Bsb\, Wog, Wog, Gll^Fmf, Gg, Gll^Fmf, Gg, Gg, Ch, Rr^Vhc, Rrc, Rr^Vhc, Rrc, Rr^Vhc, Rr^Vhc, Rrc, Ch, Gg, Gll^Fmf
Wog, Wog^Bsb\, Rrc, Gg, Rrc, Rrc, Rrc, Rrc, Gg, Ch, Ch, Rrc, Rrc, Rrc, Ch, Ch, Gll^Fmf, Gg, Gg
Wog, Wog, Gg, Rrc, Gll^Fmf, Gll^Fmf, Gg, Gg, Gll^Fmf, Gg, Gg, Ch, Ch, Ch, Gg, Gg, Gll^Fmf, Gll^Fmf, Hh
Wog, Wog, Wog, Gg, Gg, Gll^Fmf, Gg, Gll^Fmf, Gg, Gg, Hh, Hh, Rrc, Gg, Hh, Hh, Hh, Hh, Md
Wog, Wog, Wog, Gll^Fmf, Hh, Gg, Hh, Hh, Hh, Hh, Md, Hh, Md, Rrc, Md, Hh, Md, Md, Md
Wog, Wog, Wog, Hh, Gg, Hh, Gg, Hh, Md, Md, Md, Md, Hh, Rrc, Hh, Md, Md, Md, Md
