Gg, Gg, Gg, Gg, Gg, Gg, Gg^Eff, Gg, Gg, Gg, Gg, Gg, Gg, Gg, Gg, Gg, Ch, Gg, Ch, Gg, Gg, Gg, Gg, Gg, Gg, Gg, Gg, Gg, Gg^Eff, Gg^Gvs, Gg^Gvs, Gg^Gvs, Gg^Gvs, Gg^Gvs
Gg, Gg, Gg, Gg, Gg^Eff, Gg^Eff, Gg^Gvs, Gg^Eff, Gg^Eff, Gg, Gg, Gg, Gg, Gg, Ch, Ch, Gg, Rr^Vhc, Gg, Ch, Ch, Gg, Gg, Gg, Gg, Gg, Gg^Eff, Gg^Eff, Gg^Gvs, Gg^Gvs, Gg^Gvs, Gg^Gvs, Gg^Gvs, Gg^Gvs
Gg, Gg, Gg^Eff, Gg^Eff, Gg^Gvs, Gg^Gvs, Gg^Gvs, Gg^Gvs, Gg^Gvs, Gg^Eff, Gg^Eff, Gg, Ch, Ch, Gg, Gg, Gg, Gg, Gg, Rr^Vhc, Gg, Ch, Ch, Gg, Gg^Eff, Gg^Eff, Gg^Gvs, Gg^Gvs, Gg^Gvs, Gg^Gvs, Gg^Gvs, Gg^Gvs, Gg^Eff, Gg^Eff
Gg^Eff, Gg, Gg, Gg^Eff, Gg^Eff, Gs^Vh, Gg^Gvs, Gg^Gvs, Gg^Gvs, Gs^Vh, Gg^Eff, Gg^Eff, Ch, Rr^Vhc, Gg, Rr^Vhc, Ch, Ch, Ch, Gg, Gg, Rr^Vhc, Ch, Gg, Gg, Gg^Eff, Gg^Eff, Re^Vh, Re^Gvs, Gg^Gvs, Re^Eff, Gg^Eff, Gg^Gvs, Gg^Gvs
Gg^Gvs, Gg^Eff, Gg^Eff, Gg, Gg, Gg^Eff, Gg^Eff, Gg^Gvs, Gg^Gvs, Gg^Eff, Gg^Eff, Gg, Ch, Gg, Gg, Ch, Ch, 5 Kh, Ch, Ch, Rr^Vhc, Gg, Ch, Gg, Gg, Gg, Gg, Re^Eff, Gg^Eff, Re^Eff, Gg^Gvs, Re^Vh, Gg^Gvs, Gg^Gvs
Gg^Gvs, Gg^Gvs, Gs^Vh, Gg^Eff, Gg^Eff, Gg, Gg, Gs^Eff, Gg^Eff, Gg^Eff, Gg, Gg, Ch, Rr^Vhc, Gg, Gg, Rr^Vhc, Ch, Rr^Vhc, Gg, Gg, Rr^Vhc, Ch, Gg, Gg, Gg, Gg, Re^Eff, Gg^Eff, Gg^Gvs, Gg^Gvs, Gg^Gvs, Gg^Gvs, Gg^Gvs
Gg^Gvs, Gg^Gvs, Gg^Gvs, Gg^Gvs, Gg^Gvs, Gg^Eff, Gg^Eff, Gg, Gg, Gg, Gg, Gg, Rrc, Ch, Ch, Gg, Gg, Gg, Gg, Gg, Ch, Ch, Gg, Rrc, Gg, Gg, Rrc, Rrc^Vh, Re, Gg^Eff, Gg^Eff, Gg^Gvs, Gg^Gvs, Gg^Gvs
Gg^Gvs, Gg^Gvs, Gg^Gvs, Gg^Gvs, Gg^Eff, Gg^Eff, Gg, Gg, Gg, Gg, Re^Vh, Rrc, Gg, Gg, Gg, Ch, Ch, Rr^Vhc, Ch, Ch, Gg, Gg, Gg, Rrc^Vh, Rrc, Rrc, Gg^Gvs, Gg^Gvs, Gg^Gvs, Re, Re^Vh, Gg^Eff, Gg^Eff, Gg^Gvs
Gg^Gvs, Gg^Gvs, Gg^Gvs, Gg^Eff, Gg^Eff, Gg, Re, Gg, Rrc, Rrc, Gg, Re, Gg^Eff, Gg, Gg^Eff, Gg^Eff, Gg^Gvs, Ch, Gg^Eff, Gg, Gg, Gg, Gg, Gg, Gg, Rrc, Gg^Gvs, Gg^Gvs, Gg^Gvs, Gg^Gvs, Re, Gg, Gg, Gg^Eff
Gg^Gvs, Gg^Gvs, Gg^Gvs, Gg^Gvs, Gg^Eff, Re^Vh, Gg, Rrc, Gg, Gg, Gg^Eff, Re^Eff, Gg, Gg^Eff, Gg^Gvs, Gg^Gvs, Gg^Gvs, Gg^Gvs, Gg^Gvs, Gg^Eff, Gg^Eff, Gg, Gg, Gg, Gg, Rrc, Ch, Gg^Gvs, Gg^Gvs, Gg^Gvs, Re, Gg, Gg, Gg
Gg^Gvs, Gg^Gvs, Gg^Eff, Gg^Eff, Gg, Gg, Gg, Rrc, Gg, Gg^Eff, Gg^Eff, Re^Vh, Re, Gg^Gvs, Gg^Gvs, Gg^Gvs, Gg^Gvs, Gg^Gvs, Gg^Eff, Gg^Eff, Gg, Gg, Re^Vh, Re, Re, Ch, 7 Kh, Ch, Gg^Gvs, Gg^Gvs, Re^Vh, Gg, Gg, Gg
Gg^Eff, Gg^Eff, Gg, Gg, Re, Gg, Ch, Ch, Ch, Gg, Gg, Gg^Eff, Gg^Eff, Re, Re, Gg^Gvs, Re^Eff, Re^Vh, Gg, Gg, Re, Re, Gg, Gg, Gg, Ch, Ch, Ch, Re, Re, Gg, Gg, Ch, Ch
Gg, Gg, Re^Vh, Re, Gg, Re, Ch, 6 Kh, Ch, Gg, Gg, Gg, Re^Vh, Re^Eff, Gg^Eff, Re^Eff, Gg, Re, Re, Re, Gg, Gg, Gg, Gg, Gg, Gg, Rrc, Gg, Gg, Gg, Ch, Ce, Wog, Wog
Ce, Gg, Gg, Gg, Gg, Gg, Gg, Ch, Rrc, Gg, Gg, Gg, Gg, Gg, Gg, Gg, Gg, Re^Vh, Gg, Gg, Ce, Gg, Gg, Gg, Ch, Gg, Ce, Rrc, Ch, Ch, Wwg, Wwg, Wog, Wog
Wog, Ce, Ch, Gg, Gg, Gg, Gg, Gg, Rrc, Gg, Re^Vct, Gg, Ce, Re^Vct, Ce, Gg, Ce, Gg, Ch, Ch, Wwg, Ce, Ch, Ch, Wog, Ce, Wog, Ce, Wog, Wwg, Wog, Wwg, Wwg, Wog
Wog, Wwg, Wwg, Ch, Ch, Gg, Ce, Gg, Ch, Gg, Ce, 1 Ke, Wwf, Ch, Wwf, Ce, Wwg, Ch, Wog^Bw|, Wwg, Wwg, Wog, Wog, Wwg, Wwg, Wwg, Wog, Wwg, Wwg, Wog^Bw|r, Wog, Wog, Wwg, Wog
Wwg, Wwg, Wog, Wog^Bw|r, Wog, Ce, Wwg, Ch, Wog^Bw|r, Ch, Wwg, Wog, Wwg, Wog, Wwg, Wog, Wog^Bw|, Wog^Bw/, Wog, Wwg, Wog, Wog, Wog, Wog^Bw|, Wog, Wwg, Wog, Wwg, Wwg, Wwg^Bw|r, Wwg, Wwg, Gg, Gg
Gg, Wwg, Wwg, Wwg, Wog, Wwg, Wwg, Wog, Wwg, Wog, Wog, Wog, Wog, Wwg, Wwg, Wog, Wwg, Wog, Wwg, Wwg, Wwg, Wog, Wwg, Wog^Bw|, Wwg, Wog, Wwg, Wwg, Wwg, Wwg^Bw|r, Gg, Gg, Gg, Gg
Gg, Gg, Gg, Wwg^Bw|r, Wwg, Wog, Wwg, Wog, Wwg^Bw|r, Wog, Wwg, Wwg, Wwg, Wwg, Wwg, Wwg, Wwg^Bw|, Wwg, Gg, Gg, Gg, Wwg, Gg, Wwg^Bw|, Gg, Wwg, Gg, Wwg, Gg, Gg, Gg, Gg, Gd^Vhr, Gg
Gg, Gg, Gg, Gg, Gg, Wwg, Gg, Wwg, Gg, Wwg, Gg, Wwg, Gg, Gg, Gg, Gg, Rr, Gg, Gg, Gg, Gg, Gg, Gg, Rr, Gg, Gg, Gg, Gg, Gg, Gg, Gg, Gg, Gg, Gg
Gg, Gg, Gg, Gg, Gg, Gg, Gg, Gg, Gg, Gg, Gg, Gg, Gg, Gg, Gg, Gg, Rr, Gg, Gg, Gg, Gg, Gg, Rr, Rr, Gg, Gg, Gg, Gg, Gg, Gg, Gg, Gg, Gg, Gg
Gg, Gg, Gg, Gg, Gg, Gg, Gd^Vhr, Gg, Gg, Gg, Gg, Gg, Gg, Gg, Gg, Gg, Gg, Rr, Gg, Gg, Rr, Gd^Vhr, Rr, Gg, Gg, Gg, Gg, Gg, Gg, Gg, Gg, Gg, Gg, Gg
Gg, Gg, Gg, Gg, Gg, Gg, Gg, Gg, Gg, Gg, Gg, Gg, Gg, Gg, Gg, Gg, Ch, Rr, Rr, Rr, Gg, Rr, Gg, Gg, Gg, Gg, Gg, Gg, Gg, Gg, Gg, Gg, Gg, Gg
Gg, Gg, Gg, Gg, Gg, Gg, Gg, Gg, Gg, Gg, Gg, Gd^Vhr, Gg, Gg, Re, Ch, 2 Khr, Chr, Rr, Rr, Gg, Gg, Gg, Gg, Gg, Gg, Gg, Gg, Gg, Gd^Vhr, Gg, Gg, Gg, Gg
Gg, Gg, Gg, Gg, Gg, Gg, Re, Re, Re, Gg, Re, Gg, Re, Re, Gg, Chr, Chr, Ch, Rr, Rr, Re, Re, Re, Re, Re, Gg, Re, Gg, Gg, Gg, Gg, Gg, Gg, Gg
Gg, Gg, Gg, Gg, Chr, Ce, Ce, Gg, Gg, Re, Gg, Re, Gg, Gg, Gg, Gg, Gg, Gg, Rr, Rr, Gd^Vhr, Gg, Gg, Gg, Gg, Re, Gg, Re, Re, Gg, Chr, Gg, Gg, Gg
Gg, Gg, Gg, Gg, Ce, 4 Khr, Ce, Gg, Gd^Vhr, Gg, Gg, Gg, Gg, Gg, Gg, Gg, Gg, Gg, Rr, Rr, Gg, Gg, Gg, Gg, Gg, Gg, Gg, Gg, Gg, Ce, 3 Ket, Chr, Gg, Gg
Gg, Gg, Gg, Gg, Gg, Chr, Gg, Gg, Gg, Gg, Gg, Gg, Gg, Gg, Gg, Gg, Gg, Gg, Rr, Rr, Gg, Gg, Gg, Gg, Gg, Gg, Gg, Gg, Gg, Chr, Ce, Ce, Gg, Gg
Gg, Gg, Gg, Gg, Gg, Gg, Gg, Gg, Gg, Gg, Gg, Gg, Gd^Vhr, Gg, Gg, Gg, Gg, Gg, Rr, Rr, Gg, Gg, Gg, Gg, Gd^Vhr, Gg, Gg, Gg, Gg, Gg, Gg, Gg, Gg, Gg
Gg, Gg, Gg, Gg, Gg, Gg, Ce, Ce, Ce, Gg, Gg, Gg, Gg, Gg, Gg, Gg, Gg, Gg, Rr, Rr, Rr, Gg, Gg, Gg, Gg, Gg, Ce, Gg, Gg, Gg, Gg, Gg, Gg, Gg
Gg, Gg, Gg, Gg, Gg, Gg, Ce, 8 Ke, Ce, Gg, Gg, Gg, Gg, Gg, Gg, Gg, Gg, Gg, Gg, Rr, Rr, Rr, Gg, Gg, Gg, Ce, 9 Ke, Ce, Gg, Gg, Gg, Gg, Gg, Gg
Gg, Gg, Gg, Gg, Gd^Vhr, Gg, Gg, Ce, Gg, Gg, Gg, Gg, Gg, Gg, Gg, Gg, Gg, Gg, Gg, Gg, Rr, Rr, Gg, Gg, Gg, Ce, Ce, Ce, Gg, Gd^Vhr, Gg, Gg, Gg, Gg
Gg, Gg, Gg, Gg, Gg, Gg, Gg, Gg, Gg, Gg, Gg, Gd^Vhr, Gg, Gg, Gg, Gg, Gg, Gg, Gg, Gg, Rr, Rr, Gg, Gg, Gg, Gg, Gg, Gg, Gg, Gg, Gg, Gg, Gg, Gg
Gg, Gg, Gg, Gg, Gg, Gg, Gg, Gg, Gg, Gg, Gg, Gg, Gg, Gg, Gg, Gg, Gg, Gg, Gg, Gg, Rr, Rr, Gg, Gg, Gg, Gg, Gg, Gg, Gg, Gg, Gg, Gg, Gg, Gg
