Gg, Gg, Gg, Gg, Gg, Gg, Gg, Gg, Gg, Gg, Gg, Gg, Gg, Gg, Gg, Gg, Gg, Gg, Gg, Wog, Wwg, Wog, Gg, Gg, Gg, Gg, Gg, Gg, Gg, Gg, Gg, Gg, Gg, Gg, Gg
Gg, Gg, Gg, Gg, Gg, Gs^Fms, Gs^Fms, Gg, Gs^Vhr, Gs^Fms, Gs^Fms, Gs^Fms, Gg, Gg, Gg, Gg, Gs^Fms, Gg, Gg, Wog, Wwg, Wog, Gg, Gg, Gg^Vhr, Gg, Gg, Gg^Vhr, Gg, Gg, Gg, Gs^Fms, Gs^Fms, Gg, Gg
Gg, Gg, Gg^Vhr, Gg, Gg, Gg, Gg, Gs^Fms, Gs^Fms, Gs^Fms, Gs^Fms, Gs^Fms, Gg, Gg, Gg, Gs^Fms, Gs^Fms, Gs^Fms, Gs^Fms, Wwg, Wwg, Wwg, Gg, Gg, Gg^Dr, Gg, Gg, Gg, Cud, Gg, Gg, Gs^Fms, Gs^Vhr, Gs^Fms, Gg
Gg, Gg, Gg, Gg, Gg, Gg, Gg^Vhr, Gg, Gg, Gg, Gg, Gg, Gg, Gg, Gg, Gg^Vhr, Gs^Fms, Gs^Fms, Gg, Wog, Wwg, Wog, Gg, Gg, Gg, Gg, Gg, Cud, 5 Kud, Cud, Gg, Gs^Fms, Gg^Dr, Gg, Gg
Gg, Gg, Gg, Gg, Gg, Gs^Fms, Gs^Fms, Gs^Fms, Gs^Fms, Gg, Gg, Gg, Gs^Fms, Gs^Fms, Gs^Fms, Gg, Gg, Gg, Gg, Wwg, Wog, Wwg, Gg, Gg^Vhr, Gs^Fms, Gg, Gg, Cud, Cud, Cud, Gg, Gg, Gg, Gg, Gg
Gg, Gg, Gg, Gg, Gg, Gs^Fms, Gs^Fms, Gs^Fms, Gs^Fms, Gg, Gg, Gg, Gs^Fms, Gs^Vhr, Gs^Fms, Gg, Gg, Gg, Gg, Wwg, Wwg^Bw/, Wog^Bw/, Gg, Gg, Gs^Fms, Gs^Fms, Gg, Gg, Gg, Gg, Gg, Gg, Gg, Gg, Gg
Gg, Gg, Gg, Gg, Gs^Fms, Gg, Gg, Gs^Fms, Gg, Gg, Gg, Gg, Gg, Gs^Fms, Gg, Gg, Gg, Gg, Gg, Wwg^Bw/, Wwg, Wwg, Gg, Gg, Gg, Gs^Fms, Gg, Gg, Gg, Gg, Gs^Fms, Gg, Gg, Gg, Gg
Gg, Gg, Gs^Fms, Gs^Fms, Gs^Fms, Gg, Gg, Gg, Gg, Gg, Gg, Gg, Gg, Gg, Ce, Gg, Gg, Gg, Gg, Wog, Wwg, Wog, Gg, Gg^Dr, Gg, Gg, Gg, Gg, Gg^Vhr, Gs^Fms, Gs^Fms, Gs^Fms, Gs^Vhr, Gg^Dr, Gg
Gg, Gg, Gs^Fms, Gs^Fms, Gg, Gg, Gs^Fms, Gg^Vhr, Gs^Fms, Gg, Gs^Fms, Gg, Gg, Ce, 3 Ke, Ce, Gg, Gs^Fms, Gg^Vhr, Wog, Wwg, Wwg, Gg, Gg, Gg, Gg^Dr, Gg, Gg, Gg, Gs^Fms, Gs^Fms, Gs^Fms, Gg, Gg, Gg
Gg, Gg, Gg, Gg^Vhr, Gg, Gg, Gg, Gs^Fms, Gs^Fms, Gs^Fms, Gs^Fms, Gg, Gg, Ce, Ce, Ce, Gg, Gs^Fms, Gs^Fms, Wog, Wwg, Wog, Gg, Gg^Vhr, Gs^Fms, Gg, Gg, Gg, Gg, Gg, Gg, Gg, Gg, Gg, Gg
Gg, Gg, Gs^Fms, Gg, Gg, Gg, Gg, Gs^Fms, Gg, Gs^Fms, Gg, Gg, Gg, Gg, Gg, Gg, Gg, Gs^Fms, Gg, Wwg, Wwg, Wog, Gg, Gg, Gs^Fms, Gs^Fms, Gg, Gg, Gs^Fms, Gg, Gg, Gg^Dr, Gg, Gg, Gg
Gg, Gg, Gs^Fms, Gg, Gs^Fms, Gg, Gg, Gg, Gg, Gg, Gg, Gg, Gg, Gg, Gg, Gg, Gg, Gg, Gg, Wog, Wog^Bw/, Wwg^Bw/, Wog, Gg, Gg, Gs^Vhr, Gg, Gs^Fms, Gs^Fms, Gs^Fms, Gg, Gg, Gg, Gg, Gg
Gg, Gg, Gs^Fms, Gs^Fms, Gg, Gg^Vhr, Gg, Gs^Fms, Gs^Fms, Gg, Gs^Fms, Gg, Gg, Gg, Gg, Gg, Gg, Gg, Gg, Wwg^Bw/, Wog, Wwg, Wwg, Gg, Gg, Gg, Gg, Gg^Vhr, Hh^Fms, Hh^Fms, Hh, Hh, Hh^Dr, Gg, Hh
Gg, Gg, Gg, Gg, Gg, Gg, Gg, Gs^Fms, Gs^Fms, Gs^Fms, Gs^Fms, Gs^Fms, Gg, Gg, Gg, Gg, Gg, Gg, Gg, Gg, Gg, Wwg, Wog, Wog, Gg, Gg^Vhr, Hh, Hh, Hh, Hh, Cte, Hh, Hh^Vhr, Hh, Hh
Gg, Gg, Re^Vct, Gg, Gg, Gg, Gg, Gg, Gg, Gs^Fms, Gg, Gg, Gg, Gg^Vhr, Gg, Gg, Gg^Fms, Gg, Gg, Gg, Gg, Wog, Wwg, Wog, Gg, Gg^Fms, Hh^Fms, Hh, Hh, Cte, 4 Kte, Cte, Hh, Hh, Hh
Gg, Gg, Ce, Ce, Ce, Gg, Gg, Gg, Gg, Gg, Gg, Gg, Gg, Gg, Gg, Gg^Fms, Gg^Vhr, Gg^Fms, Gg^Fms, Gg, Gg, Gg, Wog, Wwg, Wog, Hh^Fms, Hh^Dr, Hh, Hh, Cte, Cte, Cte, Mm, Hh, Mm
Gg, Gg, Ce, 1 Ke, Ce, Gg, Gg, Gg, Gg, Gg, Gs^Fms, Gs^Fms, Gs^Fms, Gg, Gg, Gg^Fms, Gg^Fms, Gg^Fms, Gg^Fms, Gg, Gg, Gg, Wwg^Bw\, Wog, Wog, Hh, Hh, Hh, Hh, Hh, Hh, Hh, Mm, Mm, Mm
Gg, Gg, Re^Vct, Ce, Re^Vct, Gg, Gg, Gg^Vhr, Gg, Gg, Gg, Gs^Fms, Gs^Fms, Gg, Gg, Gg, Gg, Gg, Gg, Gg, Gg, Gg, Wog, Wwg^Bw\, Wwg^Bw\, Hh, Hh, Mm^Vhhr, Mm, Hh, Hh, Hh, Hh, Mm, Hh
Gg, Gg, Gg, Gg, Gg, Gg, Gg, Gg, Gg, Gg, Gg, Gg, Gg, Gg, Gg, Gg, Gg, Gg, Ce, Ce, Ce, Gg, Gg, Wwg, Wog, Hh, Hh, Mm, Mm, Mm, Hh, Hh, Hh^Dr, Hh, Mm
Gg, Gg, Gg, Gg, Gg, Gg, Gg, Gg, Gg, Gg, Gg, Gg, Gs^Fms, Gs^Fms, Gs^Fms, Gg, Gg, Gg, Ce, 2 Ke, Ce, Gg, Gg, Wog, Wwg, Wog, Hh, Mm, Mm, Mm, Mm, Hh, Mm, Mm, Mm
Gg, Gg, Gg, Gg, Gg^Vhr, Gg, Gs^Fms, Gs^Fms, Gs^Fms, Gg, Gg, Gg, Gg, Gs^Vhr, Gs^Fms, Gg, Gg, Gg, Gg, Ce, Gg, Gg, Gg, Wog, Wwg^Bw/, Wwg, Wog, Hh, Hh, Mm, Hh^Vhhr, Hh, Mm^Vhhr, Mm, Mm
Gg, Gg, Gg, Gg, Gg, Gg, Gg, Gs^Fms, Gs^Fms, Gg, Gg, Gg, Gg, Gg, Gg, Gg, Gg, Gg, Gg, Gg, Gg, Gg, Gg, Gg, Wog, Wwg^Bw\, Wog^Bw\, Hh, Hh, Hh, Hh, Hh, Mm, Mm, Mm
Gg, Gg, Gg, Gg, Gg, Gg, Gg, Gg, Gg, Gg, Gg, Gg, Gg, Gg, Gg, Gg, Gg, Gg, Gg, Gg, Gg, Gg^Vhr, Gg, Gg, Gg, Wog, Wwg, Hh, Hh, Hh, Hh^Dr, Hh, Mm, Mm, Mm
Gg, Gg, Gg, Gg, Gg, Gg, Gg, Gg, Gg, Gg, Gg, Gg, Gg, Gg, Gg, Gg, Gg, Gg, Gg, Gg, Gg, Gg, Gg, Gg, Gg, Wwg, Wog, Wog, Hh, Hh, Hh, Mm, Mm, Mm, Hh
