Ce, Gg, Gg, Gg, Gg, Gg, Gg, Ch, Rrc, Gg, Gg, Gg, Gg, Gg, Gg, Gg, Gg, Re^Vh, Gg, Gg, Ce, Gg, Gg, Gg, Ch, Gg, Chr, Rrc, Ch, Ch, Wog, Wog, Wog, Wog
Wog, Ce, Ch, Gg, Gg, Gg, Gg, Gg, Rrc, Gg, Gg, Gg, Chr, Re^Vct, Ce, Re^Vct, 1 Ke, Re^Vct, Ch, Ch, Wog, Chr, Ch, Ch, Wog, Chr, Wog, Ce, Wog, Wwg^Bw|, Wog, Wog, Wog, Wog
Wog, Wog, Wwg, Ch, Ch, Re^Vct, Chr, Gg, Ch, Re^Vct, Chr, Ce, Wwf, Ch, Wwf, Ce, Wog, Ch, Wwg, Wog, Wog, Wog, Wog, Wwg^Bw|, Wog, Wog, Wog, Wwg, Wwg, Wog^Bw|r, Wog, Wog, Wwg, Wog
Wwg, Wwg, Wog, Wog^Bw|r, Wog, Ce, Wog, Ch, Wwg^Bw|, Ch, Wog, Wog, Wog, Wog, Wwg, Wog, Wog^Bw|, Wwg^Bw/, Wog, Wwg, Wog, Wog, Wog, Wog^Bw|, Wog, Wog, Wog, Wwg, Wwg, Wwg^Bw|r, Wwg, Wwg, Gg, Gg
Gg, Wwg, Wwg, Wwg^Bw/, Wog, Wog, Wog, Wog, Wwg^Bw|, Wog, Wog, Wog, Wog, Wwg, Wwg, Wog, Wwg^Bw|, Wog, Wwg, Wwg, Wwg, Wog, Wwg, Wog^Bw|, Wwg, Wog, Wwg, Wwg, Wwg, Wwg^Bw|r, Gg, Gg, Gg, Gg
Gg, Gg, Gg, Wwg^Bw|r, Wwg, Wog, Wwg, Wog, Wwg^Bw|r, Wog, Wwg, Wwg, Wwg, Wwg, Wwg, Wwg, Wwg^Bw|, Wwg, Gg, Gg, Gg, Wwg, Gg, Wwg^Bw|, Gg, Wwg, Gg, Wwg, Gg, Gg, Gg, Gg, Gd^Vhr, Gg
Gg, Gg, Gg, Gg, Gg, Wwg, Gg, Wwg, Gg, Wwg, Gg, Wwg, Gg, Gg, Gg, Gg, Rrc, Gg, Gg, Gg, Gg, Gg, Gg, Rrc, Gg, Gg, Gg, Gg, Gg, Gg, Gg, Gg, Gg, Gg
Gg, Gg, Gg, Gg, Gg, Gg, Gg, Gg, Gg, Gg, Gg, Gg, Gg, Gg, Gg, Gg, Rrc, Gg, Gg, Gg, Gg, Gg, Rrc, Rrc, Gg, Gg, Gg, Gg, Gg, Gg, Gg, Gg, Gg, Gg
Gg, Gg, Gg, Gg, Gg, Gg, Gs^Vc, Gg, Gg, Gg, Gg, Gg, Gg, Gg, Gg, Gg, Gg, Rr, Gg, Gg, Rr, Gd^Vhr, Rr, Gg, Gg, Gg, Gg, Gg, Gg, Gg, Gg, Gg, Gg, Gg
Gg, Gg, Gg, Gg, Gg, Gg, Gg, Gg, Gg, Gg, Gg, Gg, Gg, Gg, Gg, Gg, Ch, Rr, Rr, Rr, Gg, Rr, Gg, Gg, Gg, Gg, Gg, Gg, Gg, Gg, Gg, Gg, Gg, Gg
Gg, Gg, Gg, Gg, Gg, Gg, Gg, Gg, Gg, Gg, Gg, Gd^Vhr, Gg, Gg, Re, Ch, 2 Kh, Ch, Rr, Rr, Gg, Gg, Gg, Gg, Gg, Gg, Gg, Gg, Gg, Gs^Vc, Gg, Gg, Gg, Gg
Gg, Gg, Gg, Gg, Gg, Gg, Re, Re, Re, Gg, Re, Gg, Re, Re, Gg, Ch, Ch, Ch, Rr, Rr, Re, Re, Re, Re, Re, Gg, Re, Gg, Gg, Gg, Gg, Gg, Gg, Gg
Gg, Gg, Gg, Gg, Ch, Chr, Chr, Gg, Gg, Re, Gg, Re, Gg, Gg, Gg, Gg, Gg, Gg, Rr, Rr, Gd^Vhr, Gg, Gg, Gg, Gg, Re, Gg, Re, Re, Gg, Ch, Gg, Gg, Gg
Gg, Gg, Gg, Gg, Chr, 4 Kh, Chr, Gg, Gd^Vhr, Gg, Gg, Gg, Gg, Gg, Gg, Gg, Gg, Gg, Rr, Rr, Gg, Gg, Gg, Gg, Gg, Gg, Gg, Gg, Gg, Chr, 3 Khr, Ch, Gg, Gg
Gg, Gg, Gg, Gg, Gg, Ch, Gg, Gg, Gg, Gg, Gg, Gg, Gg, Gg, Gg, Gg, Gg, Gg, Rr, Rr, Gg, Gg, Gg, Gg, Gg, Gg, Gg, Gg, Gg, Ch, Chr, Chr, Gg, Gg
Gg, Gg, Gg, Gg, Gg, Gg, Gg, Gg, Gg, Gg, Gg, Gg, Gg, Gg, Gg, Gg, Gs^Vc, Gg, Rr, Rr, Gg, Gg, Gg, Gg, Gg, Gg, Gg, Gg, Gg, Gg, Gg, Gg, Gg, Gg
Gg, Gg, Gg, Gg, Gg, Gg, Gg, Gg, Cer, Gg, Cer, Gg, Gg, Gg, Gg, Gg, Gg, Gg, Rr, Rr, Rr, Gg, Gg, Gg, Gg, Cer, Cer, Gg, Gg, Gg, Gg, Gg, Gg, Gg
Gg, Gg, Gg, Gg, Gg, Gg, Gg, Gg, Cer, Cer, Gg, Gg, Gg, Gg, Gg, Gg, Gg, Gg, Gg, Rr, Rr, Rr, Gg, Gg, Gg, Gg, Cer, Cer, Gg, Gg, Gg, Gg, Gg, Gg
Gg, Gg, Gg, Gg, Gs^Vc, Gg, Gg, Gg, Gg, Gg, Gg, Gg, Gg, Gg, Gg, Gg, Gg, Gg, Gg, Gg, Rr, Rr, Gg, Gg, Gg, Gg, Gg, Gg, Gg, Gg, Gg, Gg, Gg, Gg
Gg, Gg, Gg, Gg, Gg, Gg, Gg, Gg, Gg, Gg, Gg, Gg, Gg, Gg, Gg, Gg, Gg, Gg, Gg, Gg, Rr, Rr, Gg, Gg, Gg, Gg, Gg, Gg, Gg, Gg, Gg, Gg, Gg, Gg
Gg, Gg, Gg, Gg, Gg, Gg, Gg, Gg, Gg, Gg, Gg, Gg, Gg, Gg, Gg, Gg, Gg, Gg, Gg, Gg, Rr, Rr, Gg, Gg, Gg, Gg, Gg, Gg, Gg, Gg, Gg, Gg, Gg, Gg
Gg, Gg, Gg, Gg, Gg, Gg, Gg, Gg, Gg, Gg, Gg, Gg, Gg, Gg, Gd^Vhr, Gg, Gg, Gg, Gg, Gg, Rr, Rr, Gg, Gg, Gg, Gg, Gg, Gg, Gg, Gd^Vhr, Gg, Gg, Gg, Gg
Gg, Gg, Gg, Gg, Gg, Gg, Gg, Gg, Gg, Gg, Gg, Gg, Gg, Gg, Gg, Gg, Gg, Gg, Gg, Gg, Rr, Rr, Gg, Gg, Gg, Gg, Gg, Gg, Gg, Gg, Gg, Gg, Gg, Gg
Gg, Gg, Gg, Gg, Ce, Ce, Ce, Gg, Gg, Gg, Gg, Gg, Gg, Gg, Gg, Gg, Gg, Gg, Gd^Vhr, Gg, Rr, Rr, Gg, Gg, Gg, Gg, Gg, Gg, Gg, Gg, Gg, Gg, Gg, Gg
Gg, Gg, Gg, Gg, Ce, 6 Ke, Ce, Gg, Gg, Gg, Gg, Gg, Gg, Gg, Gg, Gg, Gg, Gg, Gg, Gg, Rr, Rr, Gg, Gg, Gg, Gg, Gg, Gg, Ce, Ce, Ce, Gg, Gg, Gg
Gg, Gg, Gg, Gg, Gg, Ce, Gg, Gg, Gg, Gs^Vc, Gg, Gg, Gg, Gg, Gg, Gg, Gg, Gg, Gg, Gg, Rr, Rr, Gg, Gg, Gg, Gg, Gg, Gg, Ce, 7 Ke, Ce, Gg, Gg, Gg
Gg, Gg, Gg, Gg, Gg, Gg, Gg, Gg, Gg, Gg, Gg, Gg, Gg, Gg, Ce, Gg, Gg, Gg, Gg, Gg, Rr, Rr, Gg, Gg, Gg, Gg, Gg, Gg, Gg, Ce, Gg, Gg, Gg, Gg
Gg, Gg, Gg, Gg, Gg, Gg, Gg, Gg, Gg, Gg, Gg, Gg, Gg, Ce, 5 Ke, Ce, Gg, Gg, Gg, Gg, Rr, Rr, Gg, Gg, Gg, Gg, Gg, Gg, Gg, Gg, Gg, Gg, Gg, Gg
Gg, Gg, Gg, Gg, Gg, Gg, Gg, Gg, Gg, Gg, Gg, Gg, Gg, Ce, Ce, Ce, Gg, Gg, Gg, Gg, Rr, Rr, Rr, Gg, Gg, Gg, Gg, Gg, Gg, Gg, Gs^Vc, Gg, Gg, Gg
Gg, Gg, Gg, Gd^Vhr, Gg, Gg, Gg, Gg, Gg, Gg, Gg, Gg, Gg, Gg, Gg, Gg, Gg, Gg, Gg, Gg, Gg, Rr, Rr, Gg, Gg, Gg, Gg, Gg, Gg, Gg, Gg, Gg, Gg, Gg
Gg, Gg, Gg, Gg, Gg, Gg, Gg, Gg, Gg, Gg, Gg, Gg, Gg, Gg, Gg, Gg, Gg, Gg, Gg, Gg, Gg, Rr, Rr, Gg, Gg, Gg, Gg, Gg, Gg, Gg, Gg, Gg, Gg, Gg
