Hh, Hh, Hh, Hh, Hh, Hh, Hh, Hh, Hh, Hh, Hh, Hh, Hh, Hh, Hh, Hh, Hh, Mm, Mm, Hh, Mm, Hh, Hh, Hh, Mm
Hh, Hh, Hh^Vhh, Hh, Hh, Hh, Hh, Hh, Hh, Hh, Hh, Hh, Cud, Cud, Cud, Hh, Hh, Mm, Mm, Mm, Mm, Mm, Mm, Mm, Mm
Hh, Hh, Mm, Hh, Hh^Vud, Hh, Mm, Mm, Mm, Hh^Vud, Hh, Hh, Cud, 2 Kud, Cud, Hh, Mm, Mm, Hh^Fms, Mm, Mm, Mm, Mm, Hh^Vud, Mm
Hh, Gs^Fds, Mm, Hh, Gs^Fds, Gs^Fms, Mm, Mm, Hh, Mm, Hh, Hh, Hh, Cud, Hh, Hh, Hh, Hh, Hh^Vud, Gll^Fp, Hh, Gll^Fp, Hh^Vhh, Mm, Mm
Ch, Hh, Hh, Mm, Hh, Mm, Hh, Hh, Hh^Vud, Hh, Hh^Vhh, Hh, Hh, Hh, Hh, Hh, Mm, Mm, Mm, Hh, Hh^Vhh, Mm, Hh, Hh, Ch
Gg, Ch, Ch, Hh, Hh, Hh^Vhh, Hh, Mm, Mm, Mm, Hh, Mm, Mm, Hh, Hh^Vud, Mm, Gs^Fms, Mm, Hh, Hh, Hh, Hh, Ch, Ch, Gg
Gg, Gg, Gg, Ch, Ch, Hh, Hh, Hh, Hh, Hh, Hh, Hh, Hh, Mm, Mm, Hh, Hh, Gll^Fp, Hh, Hh, Ch, Ch, Gg, Gg, Gg
Gg, Gg, Gll^Fp, Gg, Gg, Ch, Ch, Hh, Ch, Hh, Ch, Hh, Ch, Hh, Ch, Hh, Ch, Hh, Ch, Ch, Gg, Gg, Gg, Gg, Gg
Gg, Gg, Hh^Fms, Gs^Fds, Gg, Gg, Gg, Ch, Gg, Ch, Gg, Ch, Gg, Ch, Re, Ch, Gg, Ch, Gg, Gg, Gg, Gg, Gg, Gs^Vh, Gg
Gg, Gg, Gg, Gg, Gg, Gg, Gs^Vh, Gg, Gg, Gg, Gg, Gg, Gg, Re, Rp, Gg, Gs^Fds, Gg, Gg, Gg, Gg, Gg, Gg, Gg, Gg
Gg, Gg, Gs^Vh, Gg, Gg, Gg, Gg, Gll^Fp, Gs^Fds, Gg, Gg, Gg, Gs^Vh, Rb, Rb, Gg, Gs^Fds, Gs^Fds, Gg, Gs^Vh, Gg, Hh^Fms, Gll^Fp, Gg, Gg
Gg, Gg, Gg, Gg, Gg, Gg, Gg, Hh^Fms, Gg, Gg, Gg, Gg, Ce, Ce, Ce, Gg, Gg, Gg, Gg, Gg, Gg, Hh^Fms, Gg, Gg, Gg
Gg, Gg, Gg, Gg, Ce, Ce, Ce, Gg, Rb, Rb, Rb, Rb, Ce, 3 Ke, Ce, Rb, Rb, Rb, Rb, Gg, Ce, Gg, Gg, Gg, Gg
Gg, Gg, Gg, Gg, Ce, 4 Ke, Ce, Rb, Gg, Gg, Gg, Gg, Rp, Ce, Gg, Gg, Gg, Gg, Gg, Ce, 5 Ke, Ce, Gg, Gg, Gg
Gg, Gg, Gg, Gg, Gg, Ce, Gg, Gg, Gg, Gg, Gg, Gg, Rb, Rb, Gg, Gg, Gs^Fds, Gll^Fp, Gg, Ce, Ce, Ce, Gg, Gg, Gg
Gg, Gg, Gs^Vh, Gg, Gg, Gg, Gg, Gg, Gg, Gg, Gg, Gg, Rp, Rp, Gg, Gg, Gg, Hh^Fms, Gg, Gg, Gg, Gg, Gs^Fds, Gg, Gg
Gg, Gg, Gg, Gg, Gll^Fp, Gs^Fds, Gg, Gg, Gg, Gs^Vh, Gg, Gg, Rp, Re, Gg, Gg, Gg, Gg, Gg, Gg, Gg, Gll^Fp, Gll^Fp, Gg, Gg
Gg, Gg, Gg, Gg, Gg, Gll^Fp, Gg, Gg, Gg, Gg, Gg, Gg, Rb, Rb, Re, Gg, Gg, Gs^Vh, Gg, Gg, Gg, Gg, Gg, Gg, Gg
Gg, Gg, Gg, Gg, Gg, Gg, Gll^Fp, Gll^Fp, Gg, Gg, Gg, Gg, Gs^Vh, Rp, Rp, Gg, Gg, Gg, Gg, Gg, Gg, Gs^Vh, Gg, Gg, Gg
Gg, Gg, Gg, Gs^Vh, Gg, Gg, Gg, Hh^Fms, Gg, Gg, Gg, Gg, Gg, Re, Rp, Gg, Gg, Gg, Gs^Fds, Gll^Fp, Gg, Gg, Gg, Gg, Gg
Gg, Gg, Hh^Fms, Gg, Gg, Gg, Gs^Vh, Gg, Gg, Gg, Gg, Gg, Gg, Rp, Rb, Gg, Gg, Gg, Gg, Gll^Fp, Gg, Gg, Gg, Gg, Gg
Gg, Gg, Gg, Gs^Fds, Gg, Gg, Gg, Gs^Fds, Gs^Fms, Gg, Gg, Gg, Ce, Ce, Ce, Gg, Gg, Gg, Gs^Vh, Gg, Gg, Gg, Gg, Gg, Gg
Gg, Gg, Gg, Gg, Gg, Gg, Gg, Gs^Fds, Gg, Gg, Gg, Gg, Ce, 1 Ke, Ce, Gg, Gg, Gg, Gg, Gg, Gg, Gg, Gg, Gg, Gg
Gg, Gg, Gs^Vh, Gg, Gg, Gg, Gg, Gg, Gg, Gg, Gg, Gg, Gg, Ce, Gg, Gg, Gg, Gg, Gg, Gg, Gg, Gg, Gg, Gg, Gg
Gg, Gg, Gg, Gg, Gg, Gg, Gg, Gg, Gg, Gg, Gg, Gg, Gg, Gg, Gg, Gg, Gg, Gg, Gg, Gg, Gg, Gg, Gg, Gg, Gg
Gg, Gg, Gg, Gg, Gg, Gg, Gg, Gg, Gg, Gg, Gg, Gg, Gg, Gg, Gg, Gg, Gg, Gg, Gg, Gg, Gg, Gg, Gg, Gg, Gg
