Hh, Hh, Hh, Hh, Hh, Hh, Hh, Mm, Gg, Gg, Gg, Gg, Gg, Gg, Gg, Gg, Gg, Gg, Gg, Gg
Hh, Hh^Vhh, Hh, Hh, Mm, Hh, Hh, Hh, Gg, Gg, Gg, Gg, Gg, Gg, Co, Co, Ce, Gg, Gg, Gg
Hh, Hh, Hh, Mm, Mm, Mm, Hh, Gg, Gg, Gg, Gg, Gs^Fms, Gg, Gd^Vo, Co, 4 Ke, Co, Gs^Fds, Gg, Gg
Hh, Hh, Md, Hh, Hh, Hh, Gg, Gg, Gs^Fds, Gd^Vo, Gs^Fds, Gg, Gg, Gs^Fds, Gg, Ce, Gd^Vo, Gd^Vo, Gg, Gg
Hh, Hhd, Hh^Vhh, Hhd, Hh, Hh^Vhh, Gg, Gs^Fms, Gg, Gg, Gg, Gg, Gg, Gs^Fds, Gg, Rr, Rr, Gg, Gg, Gg
Hh, Hh, Md, Hh, Hhd, Hh, Gg, Gg, Gg, Gg, Gs^Fms, Gd^Vo, Gg, Gg, Gg, Rr, Rr, Gg, Gg, Gg
Hh, Md, Hh, Md, Hhd, Hh, Hh, Gg, Gg, Gg, Gg, Gg, Gs^Fms, Gs^Fds, Gs^Fds, Rr, Cte^Fms, Gg, Gg, Gg
Hh, Hh, Hh, Hh, Hh, Hh, Hh, Gg, Gg, Gg, Gg, Gg, Gs^Vc, Gs^Fds, Gs^Fds, Rr, Gs^Fds, Gs^Fds, Gg, Gg
Hh, Hh, Cte, Hh, Hh, Md, Md, Hh, Hh, Gg, Gs^Vc, Gg, Gs^Fds, Gg, Rr, Gs^Fds, Gs^Fds, Gs^Fds, Gg, Gg
Hh, Cte, 3 Kte, Cte, Hh, Hhd^Vhhr, Hh, Hhd, Hh, Gg, Gs^Fms, Gs^Fds, Rr, Rr, Gs^Fds, Gs^Fds, Gs^Vc, Gs^Fds, Gg, Gg
Hh, Cte, Cte, Cte, Hh^Vhhr, Hh, Md, Hh, Hh, Gg, Gs^Fds, Cte^Fds, Rr, Gs^Fds, Ce, Gs^Fds, Gs^Fms, Gs^Fds, Gs^Fds, Gg
Hh, Hh, Hh, Hh, Hh, Hhd, Hhd, Hh, Gg, Gg, Gg, Gg, Gs^Fds, Ce, 2 Ke, Ce, Gs^Fds, Gg, Gs^Fds, Gg
Hh, Hh, Md, Hh, Hh, Md, Hh, Hh, Gg, Gg, Gd^Vhr, Gs^Fds, Rr, Ce, Ce, Ce, Gs^Fds, Gg, Gs^Fds, Gg
Hh, Hhd, Md, Md, Hh, Hhd, Gs^Vc, Gg, Gg, Gg, Gs^Fds, Gs^Fds, Rr, Gs^Fds, Gd^Vo, Gs^Fds, Gs^Fms, Gs^Fds, Gd^Vhr, Gg
Hh, Hhd^Vhhr, Hh, Md, Gg, Gg, Gg, Gg, Gg, Gg, Gs^Fds, Gs^Fms, Gs^Fds, Gs^Fds, Gs^Fds, Gs^Fds, Gs^Fds, Gs^Fds, Gg, Gg
Md, Md, Gg, Gg, Gg, Gg, Gg, Gg, Gg, Gg, Gg, Gs^Fds, Rr, Gs^Fds, Gs^Fds, Gs^Fds, Gg, Gg, Gg, Gg
Gg, Md, Gg, Gg, Gg, Gg, Gg, Gg, Gg, Gg, Gg, Cte^Fms, Rr, Rr, Rp^Vhcr, Gg, Gg, Gg, Gg, Gg
Gg, Gg, Gg, Gg, Gg, Gg, Re^Vct, Gg, Gg, Gg, Gg, Rr, Rr, Rr, Gg, Gg, Gs^Vc, Gg, Gg, Gg
Gg, Gg, Gg, Gg, Ce, Ce, Ce, Gg, Gg, Gg, Rr, Rr, Rr, Cte, Gg, Gg, Gg, Gg, Gg, Gg
Gg, Gg, Gg, Re^Vct, Ce, 1 Ket, Ce, Re^Vct, Rr, Rr, Rr, Rr, Gg, Gg, Gg, Gg, Gg, Gg, Gg, Gg
Gg, Gg, Gg, Gg, Gg, Ce, Gg, Gg, Rr, Rr, Cte, Gg, Gs^Vh, Gg, Gg, Gg, Gs^Vh, Gg, Gg, Gg
Gg, Gg, Gg, Gg, Gg, Gg, Gg, Rr, Rr, Rr, Gg, Gg, Gg, Gg, Gg, Gg, Gg, Gg, Gg, Gg
Gg, Gg, Gg, Gg, Gg, Gg, Gg, Rr, Rr, Gg, Gg, Gg, Gg, Gg, Gg, Gg, Gg, Gg, Gg, Gg
