Ss, Ss, Ss, Ss, Ss, Ss, Ss, Ss, Ss, Ss, Gg, Ss, Wwg, Wwg, Rp, Gg, Gg, Ss, Ss, Ss, Cm, Ss, Ss, Ss, Ss
Ss, Ss, Ss, Wwg, Sm, Gg, Gg, Ss, Wwf, Gg, Wwg, Wwf, Wwg, Wwg, Rp, Wwf, Sm, Ss, Wwf, Chw, 2 Km, Cm, Gg, Ss, Ss
Wwg, Ss, Wwg, Gg, Ss, Wwg, Ss, Wwg, Sm, Sm, Wwg, Ss, Ww^Vm, Wwf, Ss, Wwg, Sm, Sm, Sm, Cm, Chw, Chw, Wwg, Ss, Ss
Ss, Wwg, Gg, Ww^Vm, Wwg, Wwg, Sm, Ss^Vhs, Gg, Ss, Gg, Ss, Wwg, Ss, Ss, Ss, Wwg, Ww^Vm, Wwf, Wwg, Wwg, Wwf, Sm, Ss, Ss
Ss, Ss, Ss, Ss, Wwf, Gg, Wwf, Wwg, Wwg, Ss^Vhs, Gg, Ss, Wwg, Ss^Vhs, Wwg, Wwg, Ss, Rp, Wwf, Ss, Ss, Wwg, Ss, Ss, Ss
Ss, Ss, Ss^Vhs, Gg, Gg, Wwf, Ss, Wwg, Ss, Sm, Sm, Wwg, Ww^Vm, Wwg, Gg, Ss, Wwf, Rp, Ss, Gg, Wwf, Ww^Vm, Wwg, Ss, Wwg
Ss, Ss, Gg, Gg, Ss, Wwf, Wwf, Gg, Wwg, Sm, Ss, Wwg, Wwg, Gg, Ss, Ss, Wwf, Wwf, Ss, Gg, Gg, Ss, Sm, Wwg, Ss
Ss, Ss, Ss, Sm, Ss, Gg, Ss, Ss, Gg, Ss, Ss, Wwg, Ss, Ss, Wwf, Rp, Wwf, Sm, Ww^Vm, Ss, Gg, Ss, Sm, Ss, Ss
Ss, Ss, Ss^Vhs, Wwg, Wwf, Gg, Wwg, Ss, Gg, Ss, Wwf, Ww^Vm, Rp, Wwf^Vhs, Gg, Rp, Ss, Sm, Wwg, Sm, Sm, Sm, Ss^Vhs, Ss, Ss
Ss, Ss, Ss, Wwf, Gg, Ss, Ss, Gg, Gg, Ss, Wwf, Gg, Sm, Sm, Ss, Wwf, Gg, Ss, Ss, Gg, Gg, Gg, Ss, Ss, Wwg
Wwg, Ss, Wwg, Ss, Wwg, Ss^Vhs, Wwg, Ss, Ss, Ss, Rp, Wwf, Wwg, Sm, Sm, Ss, Ss, Gg, Wwf, Gg, Ss, Ss, Wwg, Wwg, Ss
Ss, Wwg, Ss, Ww^Vm, Ss, Wwg, Gg, Wwg, Wwf, Gg, Wwf, Ss, Wwg, Wwg, Wwg, Wwg, Wwg, Wwg, Wwg, Wwf, Gg, Wwg, Gg, Ss, Ss
Ss, Ss, Ss, Ss, Ss, Gg, Gg, Ss, Rp, Wwf, Sm, Wwg, Gg, Gg, Ss^Vhs, Ss, Gg, Wwf, Ss, Wwg, Sm, Ss, Ss^Vhs, Ss, Ss
Ss, Ss^Vhs, Ss, Ss, Ss, Ss, Ss, Wwf, Wwf, Ss, Sm, Sm, Wwg, Gg, Ss, Ss, Gg, Gg, Ss, Ss, Sm, Gg, Ss, Ss, Ss
Ss, Ss, Ss, Ss, Gg, Ww^Ewf, Sm, Rp, Wwf, Wwg, Ss, Ww^Vm, Ss^Vhs, Ss, Ss, Sm, Sm, Wwf, Sm, Sm, Sm, Sm, Wwf, Gg, Ss
Ss, Ss, Gg, Sm, Cme, Cme, Cme, Ss, Gg, Ss, Ss, Wwg, Ss, Ss, Gg, Ss, Wwg, Sm, Gg, Wwg, Sm, Sm, Gg, Gg, Gg
Ss, Ss, Gg, Cme, Re^Vct, 1 Kme, Re^Vct, Cme, Cme, Gg, Ss, Wwg, Ss, Ss, Ss, Wwf, Wwf, Ss^Vhs, Ss, Ss, Ss, Ss, Gg, Gg, Gg
Ss, Ss, Ss, Cme, Ss, Cme, Ss, Cme, Ss, Ss, Ss, Wwg, Ss, Ss, Ss, Ss, Ss, Ss, Ss, Ss, Ss, Ss, Ss, Gg, Gg
