Hh, Hh, Hh, Hh, Hh, Hh, Hh, Hh, Hh, Hh, Ha, Hh, Hh, Hh, Hh, Hh, Mm, Ss, Ss, Ss, Ss, Ss, Ss, Ss, Ss, Ss, Ss, Ss, Ss
Hh, Hh, Hh^Fpa, Aa^Fpa, Hh^Fpa, Hh^Fpa, Hh, Ha^Vhha, Hh, Hh, Hh, Ha^Fma, Hh^Fma, Hh^Fma, Hh^Vhha, Mm, Mm, Ss, Ss, Sm, Ss, Wwg, Ss^Vhs, Ss, Cm, Ss, Ss, Ss, Rp
Hh^Fpa, Hh, Hh, Hh^Fpa, Hh, Hh, Hh, Hh, Cte, Hh, Hh, Aa^Fma, Ha, Ha^Fma, Ha, Ms, Ms, Ss, Ss, Ss, Gg, Ss, Sm, Cme, 2 Km, Cme, Ss, Rp, Ss
Aa^Fpa, Hh^Fpa, Ha^Vhha, Hh, Cte, Cte, Cte, Cte, Kte, Cte, Hh^Edb, Hh, Hh, Ha, Mm, Mm, Mm, Sm, Ss, Ss^Vhs, Gg, Ss, Ss, Cme, Cm, Cm, Ss^Vhs, Rp, Ss
Hh, Hh^Fpa, Hh, Hh^Edb, Cte, 3 Kte, Cte, Cte, Cte, Cte, Hh, Hhd^Vhhr, Hh, Mm, Gll^Fp, Mm, Sm, Ss, Sm, Sm, Wwg, Ss, Gg, Ss, Ss, Gg, Ss, Ss, Ss
Hh, Hh, Hh, Hh^Vhhr, Hh^Edb, Cte, Hh, Hh^Edb, Hh, Hh, Hh, Gll^Fp, Gll^Fp, Mm, Mm, Mm, Ss, Ss, Gg, Ss, Ss, Gg, Gg, Gg, Ss, Gg, Rp, Ss, Ss
Hh, Hh, Ha, Hh, Hh, Hh, Hh, Hh, Gll^Fp, Hh, Mm, Gll^Fp, Mm, Mm, Mm, Sm, Ss, Gg, Rb, Gg, Ss, Gg, Ss, Ss, Ss^Vhs, Gg, Sm, Ss, Sm
Hh, Hh, Hh, Ha, Gll^Fp, Hh, Ha, Hh, Gll^Fp, Hh, Gg, Hh, Gg, Mm, Ss, Ss, Ss, Ss^Vhs, Ss, Ss, Gg, Rb, Ss, Ss, Ss, Ss, Gg, Ss, Ss
Hh, Hh, Hh, Ha, Gll^Fp, Gll^Fp, Hh, Gll^Fp, Hh, Hh, Gg, Gg, Gg, Gg, Gg, Ss, Sm, Wwg, Ss, Ss, Gg, Gg, Ss, Ss, Rp, Rp, Gg, Ss, Ss
Hh, Ha, Aa^Fpa, Hh, Ha, Ha, Ha, Hh, Hh, Hh, Gg, Chr, Khr, Chr, Gg, Gg, Gg, Ss, Ss, Gg, Ss, Ss, Ss, Ss, Gg, Ss^Vhs, Sm, Ss, Ss
Hh, Ha, Hh, Aa^Fpa, Hh, Hh, Hh, Hh, Hh, Hh, Gg, Gg, Chr, Rp^Vhcr, Gg, Gg, Gg, Gg^Es, Gg, Gg, Ss, Sm, Ss, Ss, Ww^Ewf, Sm, Sm, Ss, Ss
Hh, Hh, Hh, Hh, Hh, Mm, Mm, Mm, Gg, Gg, Gg, Gg, Gg, Rp, Re, Gg, Gg, Gg, Gg, Gg, Gg, Gg, Gg, Ss, Rr, Ss, Ss, Ss, Ss
Hh, Hh, Mm, Mm, Mm, Mm, Gg, Gg, Gg, Gg, Gg, Gg, Gg, Gg, Gg, Re, Gg, Gg, Gg, Gg, Gg, Gg, Rr, Rr, Rr, Rr, Gg^Es, Gg, Gg
Mm, Mm, Gg, Mm, Gg, Gg, Gg, Gg, Gg, Gg, Gg, Gs, Gg, Gg, Gg, Gg, Gg, Rp, Re, Re, Rr, Rr, Rr, Rr, Gg, Gg, Gg, Gg, Gg
Gg, Gg, Gg, Gg, Gs, Gg, Gg, Gg, Gg, Gg, Gg, Gg, Gg^Es, Gg, Gg, Gg, Gg, Gg, Gg, Gs^Vh, Rr, Rr, Gg, Gg, Gg, Gg, Gg, Gg, Gg
Gg, Gg, Gg, Gg, Gg, Gg^Es, Gg, Gs, Gg, Gg, Gg, Gg, Gs^Es, Gg, Gg, Gg, Ce, Gd, Gg, Rr, Rr, Rr, Gg, Gg, Gg, Gg, Gg, Gg, Gg
Gg, Gg, Gg, Gg, Gg, Gs^Vh, Re, Gg, Gg, Gs, Gg, Gg, Gg, Gg, Gg, Ce, 1 Ke, Ce, Re^Vct, Rr, Rr, Gg, Gg^Esd, Gg, Gg^Gvs, Gg^Gvs, Gg^Gvs, Gg^Esd, Gg
Gg, Gg, Gg, Gs, Gg, Gg, Gg, Gg, Gg, Gg, Gg, Gg, Gg, Gg, Gg, Ce, Ce, Ce, Gg, Rr, Rr, Gg, Gg, Gg, Gg^Gvs, Gg^Gvs, Gg^Gvs, Gs^Vh, Gg
Gg, Gg, Gg, Gg, Gg, Gg, Gg, Gg, Gg, Gg, Gg, Gg, Gg, Gg, Gg, Gg, Gg, Gg, Gg, Rr, Rr, Gg, Gg, Gg, Gg, Gg^Gvs, Gg, Gg, Gg
