Gg, Gg, Sm, Sm, Gg, Gg, Gg, Gg, Gg, Gg, Gg, Gg, Gg, Gg, Gg, Gg, Gg, Gg, Gg, Gg, Gg, Gg, Gg, Gg, Gg, Gg, Gg, Gg, Gg, Gg, Gg, Gg, Gg, Gg, Gg
Gg, Sm, Gg, Sm, Sm, Gg, Ss, Gg, Sm, Gg, Ss, Gg, Ss, Gg, Gg, Gg, Gg, Gg, Gg, Gg, Gg, Gg, Gg, Gg, Gg, Gg, Gg, Gg, Gg, Gg, Gg, Gg, Gg, Gg, Gg
Gg, Sm, Sm, Gg, Chs, Ss, Gg, Ss, Sm, Sm, Gg, Ss, Gg, Ss, Ss, Ss, Ss, Gg, Gg, Gg, Gg, Sm, Sm, Gg, Gg, Gg, Gg, Gg, Gg, Gg, Chs, Chs, Chr, Gg, Gg
Gg, Gg, Sm, Chr, 3 Khs, Chr, Gg, Sm, Gg, Gg, Ss, Gg, Ss, Gg, Gg, Gg, Ss, Sm, Gs^Vht, Gg, Ss, Ss, Ss, Sm, Sm, Ss, Gg, Gg, Sm, Sm, Chr, 4 Khw, Chs, Gg, Gg
Gg, Gg, Sm, Chr, Chs, Chs, Gg, Sm, Sm, Gg, Gg, Ss, Gg, Ss, Gg, Gg, Gg, Sm, Sm, Ss, Gg, Ss, Ss^Vhs, Sm, Sm, Gg, Sm, Sm, Sm, Gg, Gg, Chr, Ss, Ss, Gg
Gg, Gg, Sm, Gg, Gg, Ss, Gg, Gg, Sm, Gg, Ss^Vhs, Gg, Ss, Ss, Gg, Gg, Ss, Sm, Sm, Sm, Sm, Gg, Gg, Sm, Gg, Sm, Gg, Sm, Gg, Ss, Ss, Gg, Ss, Gg, Gg
Gg, Gg, Sm, Gg, Gg, Ss, Gs^Vht, Gg, Gg, Sm, Gg, Ss, Ss, Ss, Ss, Ss, Gg, Ss, Gg, Sm, Ss, Sm, Sm, Sm, Gg, Ss^Vhs, Ss, Ss, Gg, Ss, Gg, Ss, Gg, Gg, Gg
Gg, Gg, Sm, Sm, Ss, Ss, Ss, Ss, Sm, Sm, Ss, Ss, Sm, Gg, Ss, Ss, Ss, Gg, Ss, Ss, Ss, Gg, Gg, Sm, Ss, Ss, Sm, Gg, Gg, Sm, Ss, Gg, Sm, Gg, Gg
Gg, Gg, Gg, Sm, Sm, Gg, Sm, Sm, Sm, Ss, Ss, Gg, Ss, Ss, Ss, Ss, Khs, Gg, Khs, Ss, Ss, Gg, Gg, Gg, Ss, Ss, Sm, Sm, Gg, Sm, Ss, Gs^Vht, Sm, Gg, Gg
Gg, Gg, Ss, Ss, Gg, Sm, Ss, Sm, Gg, Ss, Gg, Gg, Sm, Ss, Khs, Chr, Gg, Gg, Gg, Chs, Khs, Ss, Gg, Ss, Ss, Ss, Ss, Sm, Sm, Sm, Gg, Gg, Sm, Gg, Gg
Gg, Ss, Gg, Gg, Gg, Ss, Ss, Gg, Ss, Ss, Gg, Ss^Vhs, Sm, Gg, Chs, Ss^Vhs, Chr, Chr, Chr, Re^Vct, Chr, Ss, Gg, Ss, Sm, Gg, Gg, Sm, Sm, Sm, Ss, Gg, Gg, Sm, Gg
Gg, Gg, Ss, Ss, Gg, Ss, Ss^Vhs, Gg, Ss, Ss, Gg, Gg, Sm, Sm, Chr, Gg, Gg, Gg, Ss^Vhs, Gg, Chr, Ss, Ss, Ss, Gg, Gg, Gg, Ss, Ss, Gg, Ss, Gg, Ss, Sm, Gg
Gg, Gg, Sm, Gg, Gg, Ss, Gg, Ss, Gg, Ss, Sm, Sm, Gg, Gg, Chr, Gg, Chr, Gg, Chs, Gg, Chs, Ss, Gg, Ss, Sm, Sm, Gg, Gg, Ss, Ss, Ss^Vhs, Ss, Ss, Sm, Gg
Gg, Sm, Gg, Sm, Sm, Sm, Gg, Ss, Gg, Sm, Gg, Gg, Sm, Gg, Khs, Re^Vct, Gg, Chr, Gs^Vht, Gg, Khs, Gg, Gg, Ss, Sm, Sm, Sm, Gg, Sm, Gg, Ss, Ss, Sm, Sm, Gg
Gg, Sm, Gg, Gg, Ss, Sm, Sm, Gg, Gg, Sm, Gg, Gg, Sm, Gg, Sm, Chr, 1 Khs, Gg, Khs, Chr, Ss, Gg, Gg, Gg, Ss, Sm, Ss, Gg, Gg, Sm, Gg, Ss, Sm, Gg, Gg
Gg, Gg, Gg, Sm, Sm, Gg, Gg, Sm, Sm, Gg, Gg, Ss^Vhs, Ss, Sm, Gg, Sm, Ss, Gg, Ss, Ss, Gg, Gg, Gg, Ss, Ss, Ss, Ss, Ss, Sm, Sm, Gg, Ss, Sm, Gg, Gg
Gg, Gg, Sm, Sm, Sm, Gg, Gs^Vht, Sm, Sm, Gg, Ss, Ss, Gg, Ss, Ss, Ss, Ss, Gg, Gg, Gg, Sm, Gg, Sm, Ss, Gg, Gg, Sm, Ss, Sm, Gg, Gg, Sm, Ss, Gs^Vht, Gg
Gg, Gg, Sm, Gg, Gg, Sm, Gg, Gg, Sm, Ss, Gg, Gg, Gg, Gg, Gg, Gg, Gg, Ss, Sm, Sm, Gg, Sm, Sm, Sm, Sm, Gg, Gg, Sm, Gg, Gg, Sm, Sm, Ss, Gg, Gg
Gg, Sm, Sm, Gg, Chr, Sm, Gg, Gg, Ss, Sm, Sm, Gg, Gg, Gg, Sm, Gg, Ss, Sm, Gg, Ss, Ss^Vhs, Sm, Sm, Gg, Gg, Sm, Ss^Vhs, Sm, Sm, Sm, Chr, Gg, Ss, Gg, Gg
Gg, Gg, Sm, Chr, 5 Khr, Chs, Sm, Ss, Gg, Sm, Sm, Sm, Sm, Sm, Sm, Ss, Gg, Sm, Sm, Sm, Sm, Sm, Gg, Sm, Sm, Sm, Sm, Gg, Ss, Chs, 6 Khs, Chs, Ss, Gg, Gg
Gg, Gg, Sm, Chs, Chs, Chr, Sm, Ss, Ss, Gg, Gg, Gg, Ss, Ss^Vhs, Sm, Ss, Ss, Gg, Sm, Sm, Gg, Sm, Sm, Sm, Sm, Sm, Sm, Gg, Gg, Chr, Chs, Chs, Gg, Gg, Gg
Gg, Gg, Gg, Gg, Gg, Sm, Gg, Sm, Sm, Sm, Sm, Sm, Sm, Sm, Gg, Gg, Gg, Ss, Ss, Sm, Sm, Ss, Ss, Sm, Sm, Sm, Sm, Gg, Sm, Gg, Gg, Sm, Gg, Gg, Ss
Gg, Gg, Gg, Gg, Gg, Gg, Gg, Gg, Ss, Gg, Gg, Gg, Gg, Ss, Gg, Gg, Gg, Gg, Gg, Gg, Gg, Sm, Sm, Sm, Gg, Gg, Gg, Sm, Gg, Sm, Gg, Sm, Gg, Gg, Ss
Gg, Gg, Gg, Gg, Gg, Gg, Gg, Ss, Gg, Gg, Gg, Gg, Gg, Gg, Gg, Gg, Gg, Gg, Gg, Gg, Gg, Sm, Gg, Gg, Gg, Gg, Gg, Gg, Gg, Sm, Sm, Sm, Gg, Ss, Ss
